1111111111111111111111
1000000100000000000001
1000000100000000000001
100000000000000000W001
1000000100000000000001
1000000100000000000001
1111111111011111111111
1000000000000000000001
1000000000000000000001
1111111111111111111111
