1111111111
1001000001
1001000001
1000011001
1000011001
10N0000001
1000111101
1000000101
1000000101
1111111111