1111111111
1001000001
1001000001
1000011001
1000011001
1000000001
1000111101
1000000101
10000N0101
1111111111
