
NO ./textures/flower.png 


SO ./textures/wall.png

WE ./textures/back.png
C 100,50,200

EA ./textures/snail.png

F 250,100,200


        1111111111111111111111111
        1000000001100000000000011
        1011000001110000000000001
        100100000000000000S000001
111111111011000001110000000000001
100000000011000001110111111111111
11110111111111011100000010001
111011111111101110101001000111
1100000110101011100000010001
1100000000000011000000100011
10000000000000011010100100011    
1100000111010101111101111000111  
11110111 1110101 101111010001    
11111111 1111111 111111111111