11111111111111
1P0000100C0001
1000C011000001
100000C00M00E1
1000C011000001
100000C1000001
11111111111111