11111111111111
10000000000001
1P0000C00000E1
10000000000001
11111111111111