11111111111111
1P0000000C0001
100000C00000E1
1000C000000001
11111111111111